Wörter


A ha - Erlebnis = wenn man etw. begriffen hat
abgekartert = geplant
abstrakt (konkret) = theoretisch, vorgestellt (faßbar)
Abt = Vater, Klostervorsteher
Achäer = griech. Bauern
ad = zu, an, bei
adaptieren (Adapter) = verbinden, anpassen
Adjunkt = Beamter in einer höheren Position
Adjunkt = höherer Beamter, höhere Beamtenposition
adrett = hübsch, nett
Advokat = Rechtsanwalt
aero = Luft
Affäre = Angelegenheit
after = nach, hinter
Agora (Forum) = Markt
AHV = Alters- und Hinterbliebenen - Versicherung
Akademie = (Kunst)universität
Akte =  Sammlung von Schriftstücken
Aktie = Anteilschein an einer Firma
Aktuar = Schreiber eines Vereins
Akustik = Lehre vom Schall
Alibi = Nachweis persönlicher Abwesenheit zur Tatzeit am Tatort
Allah = der Erbarmer
Allegorie = Darstellung eines abstrakten Begriffs
allegorisch = sinnbildlich
Alliteration = Stabreim (Stock und Stein, Mann und Maus...)
Allmend = Land, das allen gehört
Almosen = Gabe
Amazonenstaat = Frauen haben die Macht (beherrschen die Männer mit Gewalt)
ambiziös (Ambition) = ehrgeizig
Ambrosia = Götterspeise
Analphabet = kann nicht schreiben
Anarchie = keine Herrschaftsordnung (Hierarchie)
Anarchisten = Prügler (Faustrecht), einer der keine Herrschaft anerkennt
Anatomie = Lehre vom Körper, Gliederung vom Lebewesen und Körper
Anekdote = kleine Geschichte mit berühmter Person (meistens witzig)
Anemone = Windrose, Blume
Anglerlatein = prahlende Fischer, Übertreibung
anti- = gegen
Antlitz = Gesicht
Antroposophie = ganzheitliches Denken
Apathie = Teilnahmslosigkeit (gegenüber anderer Menschen)
Apokalypse = Untergang, Unheil; Schrift, die sich mit dem Weltuntergang befaßt
Apotheose = Vergötterung, Verklärung
Appellation = Berufung
Appellationsgericht = Gericht der 2.Instanz einer höheren Stufe
appellieren = (an)rufen
Apsis (Apsiten) = Abschluß eines Kirchenraumes
Aquädukt = röm. Wasserleitungen
Ar- = Adler
Arabesken = orientalische Verzierungen
Archäologen = Urzeitforscher, Bodenexperte
Archie = Herrschaft
Architekt = Bauplaner, Baumeister
Architekton = Mutter der Künste
Architektur = Baukunst
Arie = Einzelvortrag (Oper)
Arie = Monolog (Ich-Form) bei Opern
Arier = "Edler", Herrenmenschen (blond, blauäugig); im 3.Reich Angehöriger der 
nordischen, deutschblütigen, nicht jüdischen Rasse
Aristokratie = Herrschaft der Besten, Edlen, Adelsherrschaft
arriviert = Man merkt, daß einer es zu etw. gebracht hat.
artikulieren = deutlich aussprechen
asketisch (Askese) = enthaltsame Lebensweise
Aspekt = Blickwinkel, Gesichtspunkt
Ästhetik (ästhetisch) = Lehre der Schönheit
Astrologie = Lehre der Schicksalsdeutung
Atheist = Gottesleugner (Anhänger des Atheismus)
atheistisch = nicht an Gott glaubend
Atom = unteilbar
Atrium = Innenhof
Attila (Etzel) = Vater
attraktiv = anziehend
aufgehen = man wird in ein größeres Reich einverleibt
Auge bricht = man stirbt
aula = lat. großer Raum
aus freien Stücken = freiwillig
Authentizität = Wirklichkeit, Echtheit
Autismus = krankhafte Selbst- od. Ichbezogenheit, Kontaktunfähigkeit
auto- = selbst
Autobiographie = Autor eines Buches schreibt sein Leben auf
Aversion = Gegenteil von Sympathie


bagatellisieren = verniedlichen
Bakelit = erster Kunststoff, Kunstharz
Baldachin = Thronhimmel
Ball = Tanzfest
Ballade (ballare = tanzen) = urspr. Lieder zum Tanzen; später düsterer 
(Götze/Schiller)
banal = einfach
Bank = Geldinstitut
Bankert = uneheliches Kind
bankrott = zahlungsunfähig
Bann = Ausschluß
Banner = Standarte, Fahne, Erkennungszeichen
Bannwart = ist für das Gemeindegebiet verantwortlich, Forstwart
Banquet = Bankett, Festessen
Barbier = Coiffeur (Bartschneider)
Basilika = Markthalle, Gerichtsgebäude, Kirche
Beffchen = weißer Kragen der ref. Pfarrherren zum Umbinden
behend = schnell, flink
Belletristik = schön/traurige erfundene Geschichten
Bestie = Ungeheuer
bi (tri) = 2 (3)
Biblio = Buch (von Buche)
bieder (Biederkeit) = einfach, uninteressant
Big Bang = der große Urknall
bigott = engherzig, scheinheilig, fromm, blindgläubig
Bigotterie = Scheinheiligkeit
Bio- = Leben
Biographie = Lebensbeschreibung
Biologie = Legenskunde
Bizeps = Oberarmmuskeln
Blasphemie = Gotteslästerung
blasphemisch = gotteslästerisch
Body(building) = Körper (aufbauen)
Bosporus = Meerenge bei Istanbul
Bosporus = Meerenge bei Istanbul
brabbeln = undeutlich sprechen
Brackwasser = Mischung zwischen Salz- und Süßwasser
Briefkopf = Signet des Herstellers
Brokat = teures Seidengewebe
Buchstaben = von Buchenstäbchen
Buhlschaft = Konkurrent (Liebe)
Buhurt = Turnierform (Ringkampf zwischen zwei Parteien)
bürgen (Bürgschaft) = für jem. garantieren
Burgrecht = keine Abgaben an den König od. Kaiser
Cadillac = großes amerik. Luxusauto
Champagne = Departement in Frankreich
Charade = Verwirrspiel
Charakter = wie man ist
charakterisieren = typische Merkmale zeigen
Charisma = Ausstrahlung eines Menschen
Chauvinismus = krankhafter fanatischer Nationalstolz
Chevallier = Reiter (franz. berittenes Pferd)
Chiro = Hand
Chiropraktiker = Arzt für Rückenschmerzen
Chirurg = jem., der mit der Hand operiert
Chor = im griech. Theater Meinung des Volkes
Chorybde = zwei gefährliche Strudel zwischen Sizilien und dem Festland
Chronik = Geschichte (zusammengefaßt)
chronisch = immerwährend
Chrono = Zeitmesser (Familien-, Dorfgeschichte)
Chronometer = genaue Uhr
Clan = Sippe, Großfamilie
Cocktail = gemixter Drink („Hahnenschwanz“)
Comeback = Wiedereinstieg
Comic-Strip = verschiedene Bilder nacheinander (Streifen)

Dan = Meister seines Fachs
das heimliche Gemach = Schlafzimmer
Dauphin = Kronprinz
Debatte = Diskussion in einem polit. Parlament
Decision = Entscheidung
dekadent = essen und amüsieren (Brot und Spiele), entartet
Dekret = Beschluß, Verordnung
Delle = Beule, "Buck"
Delta = Dreieck, griech. Buchstabe
Demagoge = Volks(ver)führer
Demo oder Demos = Volk, Gemeindebezirk in Athen
Demokratie = Volksherrschaft
Depression (depressiv) = krankhafter Pessimismus
der „gemeine“ Mann = der einfache Mann
Desperado = Verzweifelter, Bandit
Destille (destillieren) = Schnapsbrennerei
destillieren = alkoholisch
destruktiv = zerstörerisch
Diadochenstaaten = Nachfolgestaaten
Diagnose = Bestimmung
Dialog = Gespräch, im griech. Theater Spielhandlung mit mehr als 5Personen
Diktator = Führer der Legionen im Krieg
Diktatur = Machtausübung einer od. mehrerer Personen
Dilemma = Zwangslage, Klemme
Dilettant = Laie mit fachmännischem Ehrgeiz, Anfänger
Dirnchen = Mädchen
Dirndl = bayrisches Kleidungsstück für Frauen
dis = kehrt das Wort ins Gegenteil
Disharmonie = keine Übereinstimmung
Disputation = Streitgespräch, Red- und Antwortstehen
Dogma = Lehre
Dragoner = Reiter
drakonisch = sehr hart
Drama = literarischer Text für die Bühne, traurige Gedichtform
Dramatik = Text für die Bühne
dramaturgisch = dramatisch weiterentwickelnd
Drapierung = Ausschmückung, Behang
dräuend = drohend
drollig = lustig
Droschke = Kutsche
düpieren = täuschen, verwirren, "austrixen"

Earl = Graf
effizient = wirksam
EFTA = Europ. Freihandelsabkommen
EG = Europ. Gemeinschaft
ego = lat. ich
Egoist = auf sich bezogen, immer nur an sich Denkender
ehern = aus Eisen
ein Quentchen = ein bißchen
einpökeln (konservieren) = in Salz einlegen, haltbar machen
eiserne Männer = Ritter
Eldorado = Goldland
Elektoren = Wahlmänner
elementar = grundsätzlich
Elementarbildung = Grundwissen
Elfen, Feen = zierliche, fliegende Gestalten unbest. Geschlechts
Emblem = Hoheitszeichen
Emigranten = freiwillige Flüchtlinge
eminent = hervorragend, ganz besonders
emotional = gefühlsmäßig (seelisch)
emsig = fleißig
Enthusiasmus = große Begeisterung an etwas
Enzyklopädie = Nachschlagewerk
Epik (in Prosa geschrieben) = breitangelegte Romane
Episode = kleine Geschichte
Epoche = Zeitabschnitt, Zeitabschnitt
Epos = Vorläufer des Romans (umfassender Roman) in Versform z.B. Homer
Eremitage = Einsiedelei
Eremiten = Einsiedler
ergötzen = erfreuen
Erinnen/Eumeniden = Rachegöttinnen
erklecklich = ergiebig
Erlaß = Gesetz einführen (Edikt)
Eruption = Ausstoß/Vulkanausbruch
eruptiv = ausstoßen, ausbrechen
Ethik (ethisch) = Sittlichkeitslehre
Ethnologie (ethnologisch) = Völkerkunde
Eunuchen = kastrierte Haremswächter
Eurolex = EG-Gesetze
evakuieren = aus einer Gefahrenzone entfernen
Evolution = Entwicklung (sanft, ohne Gewalt)
EWR = Europ. Wirtschaftsraum
Exekutive = Gesetzes ausführende Gewalt (Regierung)
exerzieren = lat. üben, plagen
Existentialismus = Gegenwartsphilosophie: Vereinung des Sinnes des menschl. 
Daseins
Existenz = Lebensgrundlage
exkommunizieren = (aus der Kirche) verbannen
Expansion = Ausbreitung, Ausdehnung
extra = außerhalb

Fairneß = sportliches Verhalten
fakultativ = freigestellt, frei wählbar
famos = prächtig, großartig, ausgezeichnet
Faschisten = Anhänger (Schwarzhändler) einer rechtsradikalen  Bewegung
fatal = verhängnisvoll, unangenehm, peinlich
Fatalismus = Schicksalsergebenheit
Fauna = Tierwelt
Faustrecht = das Recht des Stärkeren
Fehde(-handschuh) = Streit, Auseinandersetzung
feminin = weiblich
Fetischist = einer, der krankhaft Frauensachen sammelt
FIAT = Fabrique Italiano Automobile Torino
Filou = Kleinkrimineller
fingieren = vortäuschen
Fixum = festgelegter Betrag
Flora = Pflanzenwelt
florieren = blühen, gedeihen, wirtschaftl. vorankommen
Flussdelta = Mündung eines Flusses
Föderalismus (Gegenteil: Zentralismus) = dem Staat weniger Macht geben
Fort = Soldatenbefestigung
Forum = Marktplatz
Fraktätchen = kleines Buch
Fraktion = in der Schweiz braucht eine Partei mind. 5 Sitze um eine Fraktion zu 
bilden
frappant = durchschlagend, beeindruckend
Fresko (Fresken) = ein Bild, das frisch auf die Wand gemalt wird
fresko = frisch, gleich auf die Wand gemalt
Freudscher Versprecher = tiefgründiger Versprecher
Frevel = böse Tat
frivol = frech, anzüglich
Fundamentalisten = Fanatiker

Gastronomie = Beiz, Restaurant
geckenhaft (Geck) = sorgfältig herausgeputzt, gepflegte Erscheinung
Geo- = Welt
Geographie = Weltaufzeichnung
-graphie/graphos = Aufzeichnung
Geologie = Weltkunde (Gesteinsschichten)
Germannen = speertragende Männer
Gestapo = Geheime Staatspolizei (die Polizei Hitlers)
gestikulieren (Geste) = Gebärden mit den Armen machen
Gevatter = Pate, Götti
Gigant = der Große
gigantisch = riesig
Gischt = die weißen Schäumchen im Meer
gleißend = starkes, aufdringliches Licht
Gnom = häßlicher Zwerg („Gnome von Zürich“ heißen die Wirtschaftsbosse von 
Zürich)
Gourmand = viel essen, die Qualität ist nicht so wichtig
Gourmet = Feinschmecker
Grammatik = Buchstabenkunde
Grammatist = früher Lehrer 
Grammophon = aufgezeichnete Töne, Schallplattenspieler
Graphologe = Schriftenforscher
Grazie = Anmut
Gremium = Gruppe, Gesamtheit
grotesk = eigenartig, verzerrt, sonderbar
Gulag = Konzentrationslager der Sowjets
Gymnos = nackt

hager = knochig
Harem, Serail = Frauenhaus
Harmonie = Übereinstimmung
Häscher = Leibwächter, Wachen
Häusler = Tagelöhner
havariert (Havarie) = (see-)beschädigt, verdorben
Hegemonie = Vormachtstellung
Hehler = einer, der gestohlenes Gut verkauft
Helge = Heiligenbildchen
Helios = Gott der Sonne
Hellenen = Griechen
Helveter = Studentenverbindung
Heraldik = Wappenkunde (Herold)
herostratisch (Hero) = heldenhaft
Herrnhuter = Verein, der auf Brüderlichkeit baut
herrnhutisch = brüderlich
Hierarchie = Herrschaftspyramide, Herrschaftsaufbau, Aufbau der Gesellschaft
Hieroglyphen = ägypt. Schriftzeichen
Hiobsbotschaft = Unglücksbotschaft
Historie = Geschichte
Historiker = Geschichtsforscher
historisch = geschichtlich
HJ = Hitlerjugend
Hobby = dt. Steckenpferd
Hochkultur = anderen voraus sein
höhnisch = spöttisch
Humanismus = auf das Bildungsideal der griechisch-antiken Schulen gegründetes 
Denken und Handeln/ zum Wohle des Menschen
humanistisch = menschlich, zivilisiert
hydra = Wasser
Hydrant = Wasseranzapfstelle
hydraulisch = mit Wasserkraft betrieben
Hymnus = Hymne, Loblied
Hypokaustanlage = Heizungsanlage
Hypothek aufnehmen = Geldkredit
Hypotheken = Grundpfand gesichertes Darlehen

Ideologie = Lehre, Theorie
Iman = rel. und polit. Führer
immanent = darin bleiben, in der betreffenden Sache enthalten
Imperium = Reich
impertinent = frech, keck
Individual = Handlung eines Einzelwesens
individuell = auf den einzelnen Menschen bezogen
Individuum (-en) = Einzelwesen
Indiz = Hinweis, verdachterregender Umstand, Anzeichen, Beweis
Infanterie = Fusstruppen
infernalisch = höllisch, teuflisch, unerträglich
Inferno = Teufel
Initiative = etwas ins Rollen bringen
Inquisition = Ketzergericht
insistieren = beharren
Instanzen = Stufen (des Gerichts)
Instinkt = sicheres Gefühle für etwas
Institutionen = Einrichtungen
Intensität = Kraft, Gewalt, Stärke, Dichte
inter = zwischen, während
Interieur = Inneres, Ausstattung eines Innenraumes
international = zwischen den Nationen
Invention = Erfindung
investieren = irgendwo Geld hineinstecken
Investitionen = große Summen geben
Investiturstreit = Streit um die Einsetzung in ein (geistliches) Amt
Inzucht = sexuelles Verkehren unter engen Verwandten
IRA = Irisch Republikanische Armee
Ironie = feiner, versteckter Spott/ unnatürliche Konstellation
ironisch = ein bißchen spötteln, nicht um zu verletzen
Islam = Hingabe zu Gott (Glaubensrichtung)
Isthmus = Landenge

Jauche = "Gülle"
Judikative = richterliche Gewalt (Gericht)
Junker = Landedelmann (Kleinadeliger)
Jura = Rechtswissenschaft
just = gerade, jetzt
Juventute = Jugend

Kadi = Richter im islam. Staat
Kaftan = typ. jüdische Kleidung, schwarze Kleidung der orthodoxen Juden
Kaisertum = Kaiser an der Spitze
Kamikazeflieger = opfern sich für das Vaterland
Kanaken = Hassname für Türken; Eingeborene der Sandwich-Inseln
Kanzler = Schreiber
Kapitalisten = Leute, bei denen Geld eine Rolle spielt
Karikatur (karikieren) = Witzzeichnung, verzerrte Gesichtszüge (einer berühmten 
Person)
Kartell = Preisabsprache
Kaskaden = kleine, terrassenförmige (stufenförmige) Wasserfälle
Kasquadeur = Zirkusturner
Kassandrarufe = vergebliche Warnungen
Kasserolle = Pfanne 
Kasserollier = Pfannenputzer
kasteien = quälen, sich gegenseitig Schmerzen zufügen
kata = hinunter
Katapulte (katapultieren) = Wurfanlage mit Löffeln (hinausschleudern)
Katarakt = Stromschnellen, Wasserfall
Katheder = erhöhtes Lehrerpult
kausal = ursächlich
Kausalhaltung = Autofahrer ist immer der Stärkere (als ein Velofahrer)
Kavalier = Reiter, Frauen gegenüber höflicher Mann
Kavaliersdelikt = vom Gesetz nicht zu ernst genommene Tat
Kavallerie = Schlachttruppen auf Pferden, Reitertruppen
keck = frech
Kentaur = Pferd mit menschl. Kopf
KGB = russischer Geheimdienst
Khan, Cäsar, Zar = Kaiser
Kipploren = kleine Eisenbahnwägelchen
Kirchweih = "Chilbi", Jahrmarkt
Kleinod = Schmuckstück
Kleptomanie = krankhafter Dieb
Koexistenz = zusammen bestehen
Kollegien = kath. Schulen
kolossal (Koloß) = riesig
komisch = lustig
Kommerz = Markt, Geschäft
kommerzialisieren = vermarkten
Kommiß = Militär
Kommission = die Parteien mit einer best. Fraktion schicken ihre Spezialisten eines 
best. Gebiets in die K.
Kommunalpolitik = in der Gemeinde
Kommune = Gemeinde
Kommunikation = (gemeinsame) Unterhaltung, gegenseitige Verständigung
Kommunismus = zusammen etw. tun, alles gehört allen (Karl Marx)
Komödie = Lustspiel
Komparse = Fremdwort für Statist
Kompetenz = Recht
Kompromiß = Mittelweg
Konfrontation = Auseinandersetzung, Gegenüberstellung
konfrontieren = sich mit etw. auseinandersetzen
konfus = verwirrt, durcheinander
Konjunktionen = Bindewörter
Konjunktur = momentane Wirtschaftslage, wirtschaftl. Aufschwung
konkret = faßbar
Konkurrenz = Gegner (drückt die Preise)
Konsequenzen = Folgen
konservativ = Gegenteil von revolutionär  = traditionsbewusst, altmodisch
Konservatorium = Musikhochschule
konservieren = etwas haltbar machen
konspirativ (konspirieren, Konspiration) = verschwörerisch
konstatieren = feststellen
konsterniert = niedergeschlagen, verwirrt, verblüfft
Konstitution = Verfassung
konstitutionell = verfassungsmäßig
konstruktiv = jem. helfen
Konsum = zusammen einkaufen
kontern = zurückschlagen
Kontext = Zusammenhang
kontra = gegen
Kontrahend = Gegner
Konturen = Umrißlinien, angedeutete Linienführung
konvertieren = den Glauben wechseln
Konzept (-ion) = Plan
Konzern = internationale Grossfirma mit vielen Tochterbetrieben
Konzession = Bewilligung, Vollmacht, Zugeständnis
Konzil = Zusammenkunft der höchsten Kirchenvertreter
kooperieren = zusammenarbeiten
Kopfstube = geheizte Stube
kopulieren = sich vermählen (früher), sich mit jem. paaren (heute)
kordinal = Grundzahl, normale Zahlen
Kordon = Kette, Ring, Seil (polizeiliche od. militärische Absperrung)
Korrespondenz = Briefe
korrespondieren = verkehren, Kontakt aufnehmen (z.B. brieflich)
-kratie = Herrschaft
Kreation = Schöpfung
Kredo = Glaubensbekenntnis (lat. ich glaube)
Krepidoma = Grenze zwischen Kultur und Natur
krepieren = elendiglich draufgehen
Krim = Insel der UdSSR (Ferieninsel der Sowjet-Bonzen)
kritisch = ungläubig, genau abwägend und prüfend
Kritisierung = Hinterfragen von Befehlen
Kryptogramm = Geheimschrift
kryptos = geheim
Kubismus = abstrakte Kunstrichtung (würfelartig)
Küfer = Hersteller von Holzfässern
kulinarisch = bezogen aufs Essen (Verb fürs Essen)
Kultur = Gegenteil von Natur, wenn der Mensch in die Natur eingreift, alles vom 
Menschen Erschaffene
kumulieren = zweimal denselben Namen auf den Wahlzettel schreiben
Kupplerin = Bordellarbeiterin, die die Kunden mit den Huren verbindet
Kürbe = Dorffest
kursiv = schräg gedruckt
kyklopische Mauern = mörtellose Mauern
Kynologie = Hundekunde, Ausbildung von Hunden

lädiert = verletzt, beschädigt
Laie = Anfänger, Nichtfachmann
lakonisch = kurz und bündig, Militärsprache
Landmann = Bauer
Landsmann = vom selben Land her stammend
Latifundien = Ländereien
latus fundus = Großgrundbesitz
leed (engl.) = führen
legal (illegal)  = gerecht
Legat = Abgesandter oder Vermächtnis
legendär (Legende) = mit vielen Geschichten verbunden, berühmt, bekannt (auch 
nach dem Tod)
Legende = Text zu einem Bild
Legenden = Geschichte um Heilige
Legierung = Gemisch aus Metallen
Legislative = Gesetzes gebende Gewalt (Parlament)
legitim (illegitim) = gesetzmäßig, berechtigt etw. zu tun
Lehen = Leihgabe
Lehrkörper = alle Lehrkräfte
Leo = Löwe
Lequalisierung = Verweltlichung    ?
liberal = freiheitlich
Liberale = Vertreter der aufklärerischen Ideen
Lichtkaskaden = kleine Lichtwasserfälle, Blinklicht
Ligerzer = Weißwein
Liktoren = Amtsdiener
Limite (Limes) = die oberste Grenze
liquidieren = flüssig machen; alle Gegenstände verkaufen, um Geld zu machen
Literatur = es geht um Geschriebenes; (Jugend-)Bücher, Gedichte
Lithikum = Steinzeit
Lithographie = Steinaufzeichnung
lithos = Stein
Liturgie = Gottesdienstform, -ablauf 
Loden = eine Art Filz aus Wolle
Logie = (Essen,) Übernachtung
-logie = Lehre od. Kunde
Lokal = Ort
lokalisieren = etwas orten
Loren = Wägelchen
Lorgnon = Stieleinglas, -brille (früher übliche Stielbrille), trägerlose Brille mit zwei 
Gläsern
lose = locker
loyal = treu und ergeben jem. gegenüber sein
ludere = spielen
Lyrik (Poetik) = Gedichte, Gedichtform

Mäander = ein Fluß mit vielen Schleifen (Mäanderornament)
Magie = Zauberkunst
Magistrat (früher) = Behörde, Beamte
Magistrat (heute) = Regierung
Mähre = altes Pferd
Majoretten = Mädchen, die an Paraden teilnehmen und mit ihren Stäbchen in der 
Luft herumfuchteln
Majorz = Mehrheit(wahl)
Makrokosmos = die Welt im Großen (Universum)
Manipulation (manipulieren) = Beeinflussung
manisch (Manie) = süchtig
Mansarde = (abgeschrägtes) Dachzimmer
Manufaktur = Fabrikbetrieb (von Hand machen)
Mär = Bericht, Kunde
Märchen = erfundene Geschichte
Marketender = Krämer, die die Soldaten im Krieg mit den nötigsten Sachen 
versorgten.
Marotte = Macke, Tick
martern = foltern, quälen
Märtyrer = einer, der für andere stirbt
maskulin = männlich
Masochist (Sacher-Masoch) = läßt sich gerne quälen
Materie = Thema
Mätresse = Nobelhure
matriarchalisch = mütterlich
maxi, mega = groß, laut, stark
Mäzen = Kunstförderer
Medea = schreckliche Frauenfigur aus der griech. Mythologie
Mediation = Vermittlung mit Schiedsrichter
Meditation = Konzentration auf den Geist
Meerbusen = große Bucht
Megalith = große Steine
Megalithkultur = Grossteinkultur
Meineid = "Falsch"eid
Melancholie = chronische Trauerkeit, träumerische -
melancholisch = wehmütig traurig
Memoiren = (Lebens-) Erinnerungen
Memoiren = Lebenserinnerungen
Mephisto = ist der Teufel in Goethes „Faust“
Meso = Mitte
Mesolithikum = Mittelsteinzeit
Mesopotamien = Zweistromland (Euphrat und Tigris)
Metier = Handwerk, Beruf
Metropole = Hauptstadt
Mikrokosmos = die Welt im Kleinen
Milizarmee = Berufsarmee
mini = klein
Minoritäten = Minderheiten
Mios maiorum = die Sitten der Väter und Vorfahren
Mirakel = Wunder
Misanthrop = Menschenfeind
Missionierung = zum ( kath.) Glauben führen
Mitra = Bischofsmütze
Mob = Abschaum (des Volkes)
modifizieren = anpassen, verzieren
Modus = Art und Weise
mollig = dicklich
Monarch = König
Monarchie = Staat mit König
mondän = nach Art der großen Welt
mono = eins, einzig, allein
Monokel = einzelnes Brillenglas
Monokultur = Eingottkultur
Monolog = Einer, der auf der Bühne steht, spricht zu sich selbst und zum Publikum.
Monomanie (monomanisch) = nur noch eine Sache im Kopf haben (z.B. Computer)
Monopol = marktbeherrschende Stellung haben
monotheistische Religion = Eingottreligion
Monumentalität = Grossartigkeit
Moritat = Bänkelsängerlied
Muse = Ruhe, freie Zeit; Göttin der Künste
Muselmänner = Mohammedaner
Muskete = Büchse, Flinte, Gewehr
Mystik = ausserkirchliche Frömmigkeit
Mythologie = Göttersagen

Nachen = kleines Schiff
nachsehen = verzeihen
Narzismus = wenn man total in sich verliebt ist, Selbstliebe
natal = geburtlich    (pränatal = vor der Geburt)
Natur = unberührt
Naturalwirtschaft = Handel ohne Geld
Nebenbuhler = Rivale um eine Beziehung
Nekro = Tod
Nekrofile = sexuell Abartige, die Sex mit den Toten haben
Nekrologe = Nachruf eines Toten (über sein Leben)
Nekropolis = Totenstadt, Friedhof
Nekrosen = Absterben von Organteilen
Nektar = Göttertrank
neo = neu, jung
Neolithikum = Neusteinzeit, Jungsteinzeit
neutrum = sächlich
New = Neugründung
Nihilismus = die philosophische Lehre vom Nichts
Nihilist = Mensch, der keine moralischen Vorsätze anerkennt, der an nichts glaubt
Nomen = Substantiv
Norm = normal
Nornen = die drei germ. Frauen, die die Schicksalsfäden spinnen                                                                                                                                                       
Nostalgie = sehnsüchtiger Hang zu Vergangenem
notorisch = immer und immer wieder, ohne Unterbruch
Novelle = mittellanger Text, neuerfundene Geschichte (ca.30-50S.)
Numeralien = Zahlenwörter

objektiv = wahrheitsgetreu, sachlich
Ode = feierliches Gedicht, Lobgesang an etw., reimlose Dichtung im kunstvollen 
Stil
Odeon = Tanz- und Musiktheater
Ödipuskomplex = psychoanalytische Bez. für frühkindliche bei beiden 
Geschlechtern sich entwickelnde Beziehung zum gegengeschlechtlichen Elternteil, 
Hinwendung des Sohnes an die Mutter
Ökologie = Umwelt
Ökonomie = Betriebs- od. Volkswirtschaft (geht ums Geld)
ökonomisch = wirtschaftl.
Oligarchie = Herrschaft der Wenigen („Fettsäcke“)
Onager = Wurfanlage mit Körbchen zum Steine reinzulegen
Opponent = Gegner
Opposition = Gegnerschaft
Optimist = positiv denkender Mensch, Grundhaltung positiv
Orakel = Weissagungsstätte
ordinal = Ordnungszahlen (ersten, zweiten...)
Ordinationszimmer = Untersuchungszimmer
Ornament = Verzierung, Muster
Ornithologe = Vogelkundler
ortho = richtig
Orthodoxe (orthodox) = Rechtgläubige
Orthographie = Rechtschreibung

Pacht = Miete
Pädagoge (früher) = Sklave, der die Kinder zum Grammatisten begleitete
Pädagoge (heute) (pädagogisch) = Lehrer, Erzieher
Pädagogik = hat mit Lehrer zu tun
Paeolithikum = Altsteinzeit
Pamphlet = Flug-, Streit-, Schmähschrift, feurige Kampfschrift
panaschieren = jem. aus einer anderen Partei wählen
Papst = Vater
parlamieren (Parlament) = reden
Parodie = man macht eine berühmte Vorlage witzig
Pascha = türkischer Offizier; einer, der nur rumkommandiert und  sich bedienen 
läßt
pathetisch = überschwenglich, übertrieben, feierlich, ausdrucksvoll, geschwollen 
(z.B. im Theater), mit viel Pathos
Pathos = Übertriebenheit
Patre od. Patres = Vater
Patria = Vaterland
patriarchalisch = väterlich
Patriatismus = Nationalismus
Patriot (patriotisch) = Vaterlandsliebender
Patriotismus = Vaterlandsliebe
Patrizier (Patron) = Adelige
pauschal = inklusive, alles inbegriffen
pax = Friede
Pazifist = Friedensanhänger, Kriegsgegner
pedantisch (Pedant) = kleinlich, peinlich genau, übergenau
Penne = Schule
Penta = fünf
Pentagon = Fünfeck
perfid = tückisch, hinterhältig, falsch
perforieren = lochen (zum Abreißen)
permanent = fortwährend, immer
Personifikation = Wenn sich Sachen wie Personen verhalten.
Personifizierung = Stielmittel
Perspektive = Blickwinkel
Pessimismus = Grundhaltung eines Menschen ist schlecht
Pessimist = negativ denkender Mensch
Pfaffe, Pfäfflein = Geistlicher
Pfefferkuchen = Lebkuchen
Phalanx = unüberwindbare Schlachtreihe
Pharmacie = Studium für Apotheker
Phil- = Freude
Philatelie = Briefmarkenkunde
Philosoph = Weisheitslehrer
Philosophie = Lehre des Denkens
phon = Ton
Phonetik = Lautschrift
Phrase = Redewendung, -weise; sinnloses Geplapper
Physiologie (physiologisch) = Lehre der Körperfunktionen
physisch = körperlich
Pike = Spieß
Pinakothek = Gemäldesammlung
Pistole = Handfeuerwaffe (Magazin im Griff)
Plackerei = harte Arbeit, Leiden
Planke = Brett
platonisch = geistig
Pleonasmus = überflüssiges Wort (z.B. schwarzer Rappe, nasses Wasser usw.)
Pöbel, Plebs = niederes Volk, Gesindel
Poesie = Dichtung
Poetik = Dichtkunst
Polis = Stadtstaat im alten Griechenland
poly = viel
Polygamie = Vielweiberei (mehr als eine Frau)
Polytheistische Religion = Vielgottreligion
pompös = übertrieben, protzig, überladen
Popanz = Narr, willenloser Mensch
portieren = einen Kandidaten stellen
Pose = gekünstelte Stellung
Poseidon = Meeresgott
Posse (possenhaft) = derblustiger Streich (Klamauk)
Posterität = Nachwelt
postulieren = fordern
Potenz = Macht, Gewalt, Kraft
prä- = vor
prädestinieren = vorausbestimmen
prägnant = prägend
Präparator = Tierausstopfer
Prätor = Richter
Premier = Sprachrohr der Mehrheit, der Erste
Primus = der Klassenbeste
primus inter pares = Bester unter Gleichen
Prinzip = Grundlage, Grundsatz
Pritsche = Massenbettlager
Privilegien = Vorrechte, Vorteile
Privilegien = Vorrechte, Vorteile
pro = für, anstelle von...
profan = weltlich, unkirchlich (alltäglich)
Profil = Gesicht, Schuhsohle, Autoreifen, schlechter Politiker
Prognose = Vorhersage
progressiv (links) = schneller Veränderungswillen
Projuventute = für die Jugend
proklamieren = verkünden
Prokura = Vollmacht
Prokurist = Handlungsbevollmächtigter (d.h. er darf ohne den Chef Verträge 
unterzeichnen)
Propaganda = polit. Werbung
prophylaktisch = vorbeugend
Proporz = Vehältnis(wahl)
Prosa = nicht dichterisch sondern in Textform abgefaßte Schrift
Proskeniom = Szene (3säulige Bühne)
Prothese = Ersatzglied
Provinz = unterworfener Bezirk, erobertes Gebiet
Provision = Zuschlag, Prämie
Prozedur = Ablauf
Prozent = auf hundert
Prozession = Umzug
Prytanen = Rat, Regierung (in Korinth)
Psalmen = rel. Lieder (der Juden)
psychisch = seelisch
psychisch = seelisch
Pufferstaaten = Satellitenstaaten
Puritaner = extreme Reformierte
purpur (König) = dunkelrot
pyro = griech. Feuer
Pyroman(ie) = krankhafter Brandstifter
Pyros = sagte: noch ein solcher Sieg und ich bin verloren
Pyrrhossieg = Sieg mit so großen Verlusten, daß man nicht mehr von Sieg sprechen 
kann

Quartier = Unterkunft
Quartier beziehen = eine Bleibe suchen
Quellen = Schriftstücke, Dokumente (Funde), Ursprung

rachitisch = Mangelkrankheit, „engl. Krankheit“
radebrechen = zusammenstottern (z.B. bei einer Fremdsprache)
radikal = von Grund auf
ratio (lat.) = Vernunft, Verstand
rationalisieren = einen Betrieb vernünftig einrichten, Verbesserungen einführen, 
vereinfachen, vernünftige Lösungen finden
raunen (Rune) = murmeln
re = wiederholen, wieder
real = auf dem Boden der Wirklichkeit
Realität = Wirklichkeit
redigieren = Arbeit eines Redaktors
Reineke = Fuchs
Reißzeug = Etui für techn. Zeichnungen (Zirkel, Tuschfeder usw.)
relativ (Relativität) = verhältnismäßig
Relegation (relegieren) = Verweisung
Renaissance = Wiedergeburt der Antike
Repräsentant = Vertreter
Republik = Staat ohne König, das Staatsvolk regiert (freier Staat)
reserviert = zurückhaltend, auf Distanz gehend
resignieren = (sich) aufgeben
resolut = fest entschlossen
Ressort = Departement (Abteilung) in der Gemeinde
Resultatsprotokoll = Beschlussprotokoll
revolutionär = etw. gewaltsam verändern wollen
Revolver = Handfeuerwaffe (mit Trommel)
Rezession = nicht wirtschaftl. Aufschwung
Rezitativ = dramat. Sprechgesang
rezitieren = vortragen
Rhetorik = Redekunst
Roman = breitangelegte, erfundene Geschichte
Romanik = Baustil im Frühmittelalter (Rundbogen)
Romanisierung = Verbreitung der röm. Kultur
Romantik = Zeit der gesammelten Märchen
Rondell = runde Anlage, kreisförmige Scheibe
Rosette = rosenförmig
Rotte = Räuber
Rune = Schriftzeichen der Germanen
rush = Rausch
rush hour = Ladenschluß

SA = Schutzabteilung (Schlägertruppen der Nationalisten)
Sabotageakt = man zerstört etw. um dem Gegner zu schaden
Sadismus (de sade) = quälen gern andere
Sage = Geschichte mit geschichtlichem Anstrich
sakral = kirchlich
Säkularisierung = Verweltlichung
Salinen = Salzbergwerke
Sanatorium = Heilstätte, -anstalt
Sancho Pansa/Rosinante (Pferd)/Don Quichote = berühmte Figuren
sanieren = aufbessern, leistungsfähig machen
Saridon = Kopfschmerztabletten
sarkastisch = bösartiger Spott
Sarkophag = kunstvoll geschmückter Sarg
Satire = Humor
satirisch = witzig, humorvoll
Schalkheit = Schlauheit
Scharlatan = Hochstapler, Heuchler
Scherbengericht = Verbannungsgericht mit Scherben als Stimmzettel
Schinderhütte = Armenhütte
schippen = schaufeln
Schirmherrschaft = Schutzherrschaft
Schisma = Spaltung
schleifen = zerstören
Schlot = Fabrikkamin
Schlüsselbilder = ganz entscheidende Bilder
Schlüsselkind = Kind dessen Eltern arbeiten (läuft mit Schlüssel herum)
schmauchen = rauchen
Scholastik = verfälschter Inhalt
Schoner = großes Segelschiff
Schulzen = Dorfpräsidenten
Sekretion = Absonderung (z.B. Eiter)
sekundär = zweitrangig, zweit
sekundärer Analphabetismus = nachträgliches Verlernen des Alphabets
sekundärer Analphabetismus = Schreiben wieder verlernt
Semifinale = Halbfinale
Senat = Rat der Ältesten
sentimental = gefühlsbetont
Session = Tagung der Parlamentarier, Sitzung
Silex = Feuerstein
simpel = einfach
Sisyphusarbeit = Arbeit, bei der kein Ende abzusehen ist
situieren = plazieren
skandieren = Gedicht übertrieben herauslesen (um herauszufinden wo die betonten 
und unbetonten Silben sind)
Skorpion = Kampfmaschine mit der man brennende Pfeile abschießen kann
soigniert = gepflegt
Sold = Verdienst eines Soldaten
solidarisch = gemeinsam, eng verbunden
Sonntagsschuss = Glücksfall, Zufall
Sophia = Weisheit
Sophismus = Scheinbeweis, Täuschungsabsichten
Sophist = Wortverdreher
Sophistik = Spitzfindigkeit
souverän = überlegen, herrschaftlich
sozial = bezogen auf die Gesellschaft, gesellschaftl.
Spekulation = vage Berechnung
spekulieren = vermuten
Sperber = einer, der genau schaut
Spiessrutenlauf = Strafmaßnahme für Kriegsgefangene
Sponsor = Finanzierer, Geldspender, Geldgeber
spontan = unüberlegt, nicht geplant
Spontanität = reagieren ohne lange zu überlegen
Stalde = Bez. eines Ortes, der ansteigt
Stand = Kanton
Statist/ Komparse = kleine Theaterrolle; Person, die im Hintergrund steht - eine 
Filmperson, die nichts sagt
Stenographie = Kurzschrift
Stratege = Heerführer (z.B. Temistokles)
Strategie = Kriegsplanung (Grossplan)
Strophe = einige Verszeilen (ca.4)
Strukturen = Formen, die sich häufig wiederholen; Aufbau
stupid = dumm, blödsinnig
subjektiv = persönlich gefärbt
Subvention = Beihilfe, Unterstützung (aus öffentl. Mitteln)
suggerieren = jem. beeinflussen
suggestiv = beeinflußt
Suizid = Selbstmord
Syllogismus = (Vernunft-)schluß
Symptom = Anzeichen
Synonym = gleichbedeutendes Wort
Syrakus = liegt auf Sizilien

Takelwerk = Seile, um die Segel zu bedienen
Taktik = Verfeinerung, kleinere genauere Planung
Talar = prot. Pfarrerkleid
Talmud = Sammlung der Gesetze des nachbiblischen Judentums              
Talmudist = Kenner des Talmud
Tartan = Kunststofflaufbahn-Belag
Tartarus = Unterwelt, Schattenwelt
tele = fern
Telepathie = Gedankenübertragung
Teleskop = Fernrohr
Territorialgebiet = größere, zusammenhängendere Gebiete
Theater = Ort an dem etw. schaubar gemacht wird
theatralisch = leicht übertrieben
theatron (griech.) = der Ort
Theist = glaubt an Gott
theo = Gott
Theokratie = Gottesstaat    
Theologie = Kunde von Gott
-thek = Behälter
Thermen = warme Heilquellen
thermo od. thermos = warm
These = Idee
Thron = Königssitz
Tirade = Redeschwall
Tischzucht = Tischregeln
Toleranz = Duldsamkeit
tolerieren = erdulden
Tornister = rucksackähnlicher Behälter, fellüberzogener Behälter
Torturen = Folter, Qualen
tradieren = überliefern
Tradition = etw. das weitergegeben wird
Tragikomödie = lustig und traurig (nachdenklich)
Tragödie = Trauerspiel
tragos = Bock
Traktandenliste = Zusammenstellung des Programmes einer Sitzung
Traktandum = Vehandlungsgegenstand
Traktat = wissenschaftl. Abhandlung, rel. Schrift, Vertrag
traktieren = behandeln, plagen
transferieren = übertragen
Trauerode = Chorgesangsstück, reimlose Dichtung
treideln = Schiffe mit Hölzer über das wasserlose Land transportieren
Tribun = Vertreter
Tribunal = Gericht
Troja-Politik = nicht mit offenen Karten spielen
Trott = halbschneller Gang
Trott = halbschneller Gangart
Trüffel = teure Pilze
Trust = Konzern (Großbetrieb)
tuberkulös = schwindsüchtig, an Tuberkulose leidend
Tuberkulose = Infektionskrankheit
Tugend = gute Eigenschaften
Turnier = Ernstkampf simulieren
Tyrann = Unterdrücker, Alleinherrscher
Tyrannis = Alleinherrschaft

Ultimatum = entweder-oder-Forderung unter Drohung während einer bestimmten 
Frist
umfloort = umwachsen
umflort = mit Tränen getrübtem Blick
unkritisch = alles glauben
unstet = ruhelos
urban = städtisch
urbar = bebaubar
urbar machen = vorbereiten um es zu bebauen, roden, bebaubar machen
Utensilien = Hilfsmittel
Utopie = Zukunftsvision

vage = unbestimmt, ungewiß, unklar, nicht klar definiert
Variation = verschiedene Richtungen, andere Möglichkeit
Vasall = Knecht
Vatikan = Kirchenstaat, Sitz des Papstes
Vendetta = Blutrache
verhehlen = verheimlichen, verstecken
Verlaufsprotokoll = ausführlicher Bericht
Vernehmlassung (Politik) = Befragung solcher, die mit dem Thema etw. zu tun 
haben nach ihrer Meinung, Vorschlag, Besprechung, Einweihung der informierten 
Kreise über Veränderungen
Vers = eine Zeile eines Gedichts
Versfuss = Rhythmus eines Gedichtes
Version = Aussage, Fassung, Wiedergabe
Veteranen = ausgetretene Legionäre
veto = ich verbiete
via = hinüber
Viadukt = Brücke
view = Sicht
Villa = stattliches Haus
virtuos = meisterhaft
Virtuose = Meister im z.B. Klavier- od. Geigenspiel
Vision = mit den Augen erkennen, sehen, Erscheinung
Vitalität = Lebensfreude
Vivisektion = operativer Eingriff an lebenden Tieren
vogelfrei = wenn man mit jem. machen kann, was man will
von der Pike auf gelernt = man hat alles gemacht: einfach angefangen und dann 
hochgearbeitet; von Grund auf gelernt
Vorspann (Leed) = Kurzzusammenfassung, Einführung bei einem Zeitungsartikel

Wall = aufgeschüttete Erde
wallen = jubeln
Wallhalla = Götterburg der germ. Götter
Wandalen = ein germ. Stamm; sinnlose Zerstörer
Wandalenakt = sinnlose Zerstörungsaktion
Weise = Melodie
Wesir = Minister
Wodka = hochprozentiger russischer Schnaps

x = unbekannt

Zäsur = Einschnitt, kurze Pause
zechen = rauchen/trinken
Zecherei = Trinkerei
Zensur = Beurteilung, Note; Überprüfung, Filterung
zensurieren = überprüfen, filtern
Zentralismus = dem Bund mehr Macht
zerspellen = von einem Scheit Späne zum Anfeuern abspalten, zerspalten
Zierarten = verschiedene Verzierungen
Zierrat = Verzierung
Zivilisation = die Menschheit und ihre Sitten
Zölibat = Ehelosigkeit
Zunft = Verein von Handwerkern derselben Branche         
zynisch = gemein, spöttisch, frech ("zünde"), gemäßigter Spott, bissig
Zynismus = Spotten mit Ironie
